3,3,3,3,3,3,3
3,0,0,0,0,0,3
3,0,0,5,4,4,3
3,1,0,6,5,0,2
3,0,0,5,0,0,3
3,3,3,3,3,3,3