3,3,3,3,3,3,3,3,3
3,3,0,0,0,0,0,0,3
3,5,0,0,3,0,0,0,3
3,3,0,8,0,5,3,0,2
3,0,5,0,0,0,0,0,3
3,1,0,0,3,0,0,3,3
3,3,3,3,3,3,3,3,3