3,3,3,3,3,3,3,3
3,0,0,0,0,3,3,3
3,0,5,6,5,3,2,3
3,1,0,0,0,3,0,3
3,0,8,9,0,0,0,3
3,3,0,0,0,5,0,3
3,3,3,3,3,3,3,3