3,3,3,3,3,3,3,3
3,0,0,0,0,5,0,3
3,0,1,0,0,0,0,2
3,0,0,0,0,9,5,3
3,3,3,3,3,3,3,3