3,3,3,3,3,3,3,3,3
3,0,0,0,3,0,0,5,3
3,1,5,6,5,0,0,0,3
3,0,0,0,3,0,0,0,2
3,3,3,3,3,3,3,3,3