3,3,3,3,3,3,3,3,3,3
3,3,3,3,3,5,0,0,0,1
3,0,0,0,0,6,5,9,0,3
3,0,0,0,0,5,0,0,0,3
3,0,5,0,8,0,3,0,0,3
2,0,0,0,0,0,3,3,3,3
3,0,0,0,0,0,0,3,3,3
3,3,3,3,3,3,3,3,3,3
