3,3,3,3,3,3,3
3,1,0,5,0,0,3
3,4,4,3,5,0,2
3,0,0,0,0,0,3
3,0,3,3,3,3,3
3,3,3,3,3,3,3