3,3,3,3,3,3,3,3,3
3,0,0,0,0,0,0,0,3
3,0,0,0,0,0,0,0,3
3,3,3,5,6,5,5,4,3
3,0,0,0,0,0,4,0,3
3,1,0,0,0,0,0,0,2
3,3,3,3,3,3,3,3,3