3,3,3,3,3,3,3,3,3,3,3
3,1,0,5,5,0,5,5,0,0,3
3,0,5,0,0,5,0,0,5,0,3
3,0,5,0,0,0,0,0,5,0,3
3,0,0,5,0,0,0,5,0,0,3
3,0,0,0,5,0,5,0,0,0,3
3,0,0,0,0,5,0,0,0,0,3
3,3,3,3,3,2,3,3,3,3,3