3,3,3,3,3,3,3,3,3,3
3,1,0,0,0,0,0,0,0,3
3,0,5,0,5,0,0,0,0,3
3,0,9,8,0,0,5,0,0,2
3,0,0,0,0,0,0,5,0,3
3,0,0,0,0,0,0,0,8,3
3,0,0,0,0,8,0,5,9,3
3,0,0,0,0,0,0,0,0,3
3,3,3,3,3,3,3,3,3,3